R 1920 1080
NO brick_1.xpm
EA wall2.xpm
SO stone.xpm
WE sculp.xpm

S wall_tex.xpm
F 200, 80, 0
C 240, 60, 0

        1111111111111111111111111
        1000000000110000000000001
        1011000001110000002000001
        1001000000000000000000001
111111111011000000000000000000001
100000000011000000000000111111111
11110111111111011100000000001
1111011111111101110101000W001
11000000110101011200000010001
10002000000000001100000010001
10000000000000001101010010001
1100000111010101112101111000111
11110111 1110101 101111010001
11111111 1111111 111111111111